/Users/wangyichen/Downloads/kungfu.png
/Users/wangyichen/Downloads/New Piskel (7).png
45
45
80
10
56 56 56 56 56 56 56 56 56 56 56 56 56 56 56 56 56 56 56 56 56 56 56 56 56 56 56 56 56 56 56 56 56 56 56 56 56 56 56 56 56 56 56 56 56 56 56 56 56 56 56 56 56 56 56 56 56 56 56 56 56 56 56 56 56 56 56 56 56 56 56 56 56 56 56 56 56 56 56 56
55 55 55 55 55 55 55 55 55 55 55 55 55 55 55 55 55 55 55 55 55 55 55 55 55 55 55 55 55 55 55 55 55 55 55 55 55 55 55 55 55 55 55 55 55 55 55 55 55 55 55 55 55 55 55 55 55 55 55 55 55 55 55 55 55 55 55 55 55 55 55 55 55 55 55 55 55 55 55 55
55 54 54 54 54 52 54 54 51 54 37 50 54 54 54 54 54 54 34 42 37 54 54 51 54 54 54 54 54 47 54 54 54 54 54 54 54 54 54 54 54 54 9 54 54 54 54 54 54 54 54 54 54 54 54 54 54 54 54 54 54 54 54 54 51 54 51 54 54 54 54 54 54 54 19 19 19 54 54 54
54 54 54 54 54 54 34 37 52 31 54 54 54 54 54 54 54 53 44 30 50 54 31 54 54 54 47 54 45 54 34 54 46 54 54 54 54 54 54 54 19 19 19 54 54 54 54 54 54 54 54 54 54 52 54 54 52 54 51 54 54 54 54 54 38 54 29 54 54 51 19 19 19 54 54 54 54 54 51 54
54 54 54 54 53 34 33 30 41 54 19 54 54 54 54 54 54 54 9 54 38 37 53 54 54 54 49 38 44 19 43 37 54 54 54 54 54 54 52 54 54 52 52 45 54 51 54 54 54 54 54 54 54 54 28 54 27 31 54 54 54 54 54 54 35 29 54 38 35 54 54 54 54 54 54 54 52 29 28 54
54 54 54 54 54 54 54 34 28 54 18 54 54 54 54 54 54 54 19 28 31 54 54 19 54 54 54 47 29 18 31 54 54 54 54 54 54 54 54 38 54 33 54 38 41 54 54 54 54 54 54 54 53 38 28 50 31 51 54 54 54 54 54 53 54 43 38 31 40 54 54 54 54 54 54 54 54 54 30 50
54 54 54 54 54 54 19 54 23 54 18 54 54 54 54 54 54 54 18 21 21 19 19 18 54 54 19 48 54 18 23 54 54 19 54 54 19 54 54 53 30 44 54 37 19 54 54 54 54 54 54 54 54 54 29 54 28 54 54 54 19 54 54 54 54 10 33 19 54 50 54 54 54 54 54 54 19 54 37 44
54 19 19 19 19 19 18 54 24 37 18 54 54 54 54 19 54 54 18 18 18 18 18 18 54 54 18 54 54 18 21 54 54 18 19 19 18 54 54 54 54 34 27 54 18 54 54 54 54 54 54 54 54 54 19 30 23 37 54 54 18 19 54 54 54 20 28 18 54 54 54 54 54 19 54 54 18 53 29 54
54 18 18 18 18 18 18 27 24 45 18 54 54 54 54 18 54 27 18 18 18 18 18 18 54 54 18 54 54 18 18 54 54 18 18 18 18 54 54 54 19 27 32 19 18 54 54 19 54 54 19 54 54 54 18 54 26 54 19 19 18 18 19 54 27 18 21 18 54 54 19 54 54 18 19 54 18 54 27 11
54 18 18 18 18 18 18 22 24 23 18 54 19 54 54 18 54 22 18 18 18 18 18 18 54 54 18 54 54 18 18 28 54 18 18 18 18 54 54 54 18 22 54 18 18 54 54 18 54 54 18 19 19 19 18 27 23 54 18 18 18 18 18 54 22 18 18 18 54 54 18 54 54 18 18 54 18 54 22 21
