/Users/MajestyElestra/Downloads/old_castle.png
/Users/MajestyElestra/Downloads/stone.png
45
45
20
50
6 6 6 6 6 6 6 6 10 6 6 6 6 6 6 5 6 6 6 6
6 6 7 6 6 6 6 6 6 6 4 6 6 6 6 6 6 6 6 6
6 6 6 6 6 1 1 1 6 6 0 0 0 6 6 0 0 0 6 6
6 6 6 6 6 6 6 6 6 6 6 6 0 6 6 6 6 6 6 2
6 6 1 1 1 1 6 6 6 6 6 0 0 6 6 6 6 6 6 3
6 6 6 6 6 6 6 6 6 6 0 0 6 6 6 6 1 6 1 0
6 6 6 6 5 6 6 6 11 0 0 6 6 6 6 6 6 6 6 6
6 6 6 6 6 6 6 6 0 0 6 6 6 6 1 6 6 6 6 10
0 0 6 6 0 11 6 6 0 6 6 6 9 6 6 1 6 6 6 6
6 6 6 6 0 0 6 6 1 6 6 6 6 6 6 6 1 6 6 6
6 6 6 6 6 0 6 6 1 6 6 6 6 6 6 6 1 1 6 6
6 9 6 6 6 0 6 6 1 1 1 1 6 6 6 6 6 6 6 6
6 12 13 6 6 6 6 6 6 2 6 1 1 6 6 6 6 6 4 6
5 14 15 5 6 6 6 6 6 3 6 6 6 6 6 1 1 1 1 6
6 16 17 6 6 0 0 0 0 0 6 6 6 6 1 6 6 6 6 6
1 1 1 1 1 6 6 6 6 6 6 6 4 6 6 6 6 6 6 6
6 6 6 6 6 6 6 6 6 6 6 6 0 1 6 6 6 5 6 6
6 6 6 6 6 6 5 6 6 6 0 0 6 6 6 6 6 6 6 6
6 6 6 6 6 6 6 6 1 0 6 6 6 6 6 6 1 1 6 6
6 6 6 7 6 6 1 1 6 6 6 6 6 6 6 6 6 6 6 6
6 6 6 6 0 0 6 6 6 6 6 1 1 1 6 6 6 6 8 6
11 4 6 6 6 6 6 6 6 6 6 7 6 6 6 5 6 6 6 6
0 0 6 6 6 6 6 6 6 6 6 6 6 6 1 6 6 6 6 6
6 6 1 6 6 6 9 6 1 1 1 1 6 6 1 1 6 5 6 6
6 6 6 6 6 6 6 6 6 6 6 6 6 6 1 1 1 6 6 6
6 6 6 6 1 6 6 6 6 6 6 6 11 6 6 6 1 1 6 6
6 6 6 6 6 6 6 6 7 6 6 0 0 6 6 6 0 1 1 6
6 6 1 6 6 6 6 6 6 6 6 6 6 6 6 6 0 6 6 6
6 6 6 6 6 6 6 6 0 0 6 6 6 6 6 6 0 6 6 6
0 6 6 6 6 6 6 6 6 6 6 6 6 6 6 6 6 6 6 0
6 6 6 6 6 6 0 0 6 6 6 6 6 6 6 6 6 6 0 0
6 6 0 6 6 6 6 6 6 5 6 6 6 6 0 0 0 0 0 0
6 6 6 6 6 6 6 6 6 6 6 6 6 6 6 6 6 6 6 6
6 6 6 6 1 1 1 1 1 1 1 1 6 6 6 6 6 6 6 6
6 7 6 6 6 6 6 6 6 6 6 6 6 6 6 6 6 9 6 6
6 6 6 6 6 6 6 6 6 6 6 6 6 4 6 6 6 6 6 6
6 6 6 6 6 6 6 6 6 6 0 0 0 0 6 6 6 6 6 6
6 6 5 6 6 10 6 6 6 6 6 6 6 0 0 0 6 6 6 6
6 11 6 6 6 6 6 6 6 6 6 6 6 6 6 6 6 5 6 2
6 1 1 6 6 6 6 6 6 6 6 6 6 6 6 6 6 6 6 3
6 6 6 6 6 6 6 5 6 6 1 1 1 6 6 6 1 1 1 1
6 6 6 6 6 6 6 6 6 6 6 6 6 6 6 6 6 6 6 6
6 6 6 6 6 6 6 1 1 1 6 6 6 6 0 6 6 7 6 6
6 9 6 6 6 6 6 6 6 6 6 6 6 6 6 6 6 6 6 6
6 6 6 6 6 1 1 6 6 6 6 1 1 6 6 6 6 6 6 6
6 6 6 6 6 6 6 6 6 6 1 0 0 1 6 6 6 6 6 6
6 6 6 1 1 6 6 6 6 6 1 0 1 1 0 6 6 6 5 6
6 6 6 6 6 6 6 6 6 0 1 1 1 1 0 1 6 6 6 6
6 6 6 6 4 4 6 6 0 1 1 1 0 1 1 0 1 6 11 6
0 0 0 0 0 0 0 0 0 0 0 0 0 0 0 0 0 0 0 0
