/Users/wangyichen/Desktop/NEU/GameEngine/assignment2/testTileEditor/snowscene.png
/Users/wangyichen/Downloads/New Piskel (8).png
45
45
80
10
10 10 10 10 10 10 10 10 10 10 10 10 10 10 10 10 10 10 10 10 10 10 10 10 10 10 10 10 10 10 10 10 10 10 10 10 10 10 10 10 10 10 10 10 10 9 10 10 11 10 10 10 10 10 10 10 10 10 9 10 10 9 10 10 10 10 10 10 10 10 10 10 10 10 10 10 10 10 9 10
10 10 10 9 10 10 10 10 9 10 10 10 10 9 10 10 10 10 10 10 10 10 10 10 10 10 10 10 10 9 10 10 10 10 10 10 10 10 10 10 10 10 10 10 10 10 10 10 10 10 10 10 9 10 10 10 10 10 10 13 17 10 10 10 10 10 10 9 10 10 10 10 10 10 10 10 10 10 10 10
10 9 10 10 10 10 10 10 10 10 10 10 10 10 10 10 10 10 10 10 19 10 10 10 10 10 10 10 10 10 13 14 10 10 10 9 10 10 10 10 10 10 10 10 10 10 10 10 10 10 10 10 10 10 10 10 10 10 12 18 18 17 10 10 10 10 10 10 10 10 10 10 9 10 10 10 10 10 10 10
10 10 10 13 14 10 10 10 10 10 10 10 10 10 10 10 10 6 10 10 10 10 10 10 10 10 10 10 10 12 18 18 17 10 10 10 10 10 10 10 10 10 10 9 10 10 10 10 10 10 10 10 10 10 10 10 9 12 18 18 18 18 17 10 10 10 10 10 10 10 10 10 10 10 10 10 10 10 10 10
10 10 12 18 18 17 9 10 10 10 10 10 10 10 10 16 10 7 10 10 10 10 10 10 10 10 10 10 12 18 18 18 18 17 10 10 10 10 10 10 10 10 10 10 10 10 10 10 10 10 10 10 10 10 10 10 12 18 18 18 18 18 18 17 9 10 10 10 10 10 10 10 10 10 10 10 10 10 10 10
10 12 18 18 18 18 17 10 10 10 10 10 9 10 13 22 1 1 21 10 10 10 10 10 10 10 10 23 18 18 18 18 18 18 17 10 6 10 10 10 10 10 10 22 1 21 10 10 10 10 10 10 10 12 14 12 18 18 18 18 18 18 18 18 17 10 10 10 9 10 10 10 10 10 9 10 10 10 10 10
12 18 18 18 18 18 18 3 10 10 10 10 10 12 18 18 18 17 10 10 10 10 10 10 10 10 12 2 18 18 18 18 18 18 18 17 7 10 10 11 10 10 10 10 12 18 14 11 10 10 10 10 4 18 18 18 18 18 18 18 18 18 18 18 18 23 10 10 10 23 10 10 10 10 10 10 10 10 6 10
18 18 18 18 18 18 18 8 17 10 10 23 12 18 18 18 18 18 17 10 10 10 23 10 10 12 22 2 18 18 18 18 18 18 18 18 23 10 10 10 10 10 10 12 18 18 18 17 10 10 10 12 8 18 18 18 18 18 18 18 18 18 18 18 18 18 17 10 10 10 10 10 10 10 10 10 10 10 7 10
0 0 0 0 0 0 0 0 0 0 0 2 21 18 18 18 18 18 18 17 10 22 2 1 1 1 2 2 18 18 23 18 18 23 18 18 2 17 10 22 1 1 2 2 2 2 2 2 17 10 12 18 22 1 1 21 18 18 18 18 18 18 18 18 18 18 18 17 10 10 10 10 10 10 10 22 1 1 1 1
2 2 2 2 2 2 2 2 2 2 2 2 2 2 2 2 2 2 2 2 2 2 2 2 2 2 2 2 18 22 2 18 18 2 18 18 2 18 17 2 2 2 2 2 2 2 2 2 18 17 18 18 2 2 2 2 2 2 2 18 18 2 18 18 2 2 18 18 10 2 2 10 10 10 10 2 2 2 2 2
